Archie Bronson Outfit - Cherry Lips
Fiona Apple - Shameika
tvrde_mixdown
Rust Red Romance - When I Grow Up
Will Butler - Anna 
Etceteral - Viking
And The Kid - Sounds Like Heaven
Ekatarina Velika - Tatoo
These New Puritans - Elvis
RS id
of Montreal - The Past Is A Grotesque Animal 
Bonaparte - Do You Want to Party
King Gizzard & The Lizard Wizard - I'm In Your Mind
Dinosaur Jr - The Wagon
Meat Puppets - Backwater
Nirvana - Breed
Fela Kuti - He Miss Road
Geraldo Pino & The Heartbeats Let them talk
daisy dives - slap
nemanja - Rama Disco
Mulatu Astatke & The Heliocentrics - Blue Nile
The Brian Jonestown Massacre - Straight Up And Down
Far Caspian - Blue
Goribor - Jureći ljubav
All Them Witches - Am I Going Up
Yin Yin - Dis kô Dis kô
Thee Oh Sees - Adult Acid
The Grodeck Whipperjenny - Why Cant I Go Back
CAN - She Brings The Rain
Idles - Mercedes Marxist
The White Stripes The Hardest Button To Button
Tom Tom Club - Genius Of Love
The Dolly Rocker Movement - The Only One
Khruangbin - August 10
The Murlocs - Problematic Subject
Tom Waits - Telephone Call From Istanbul
Charles Mingus - Moanin'
The Clash - Police & Thieves
Allah las- De vida Voz
The Wolfhounds - The Anti-Midas Touch
Burning Alms - Everyone You Know
Biig Piig - Switch 
The Asteroid No. 4 - Northern Song
Silver Falcons - Zagreb 89
I LIKE TRAINS - A Steady Hand
Animal Collective - My Girls
The Do - Gonna Be Sick
Coma Stereo - Harakiri
Spoon - Written In Reverse 
Tine Nymann - Into the daylight
A shoreline dream - Melting
OSees - Chem Farmer Nite Expo
Piccolo Pete - Annoying
Well Hung Heart - This Is Not Love
Lynch - [Post-sup Revival]
DIIV - Doused
b3 janet
Mogwai - I'm Jim Morrison, I'm Dead
The Editors - You Don't Know Love (Cagedbaby Remix)
Majke - Zelim Da Te Vidim
Russian Circles - Fathom
arnold, dolf i maet dejmon
JOY DIVISION - isolation
Goribor - Vreme
Interpol - Length of Love
Scott And Charlenes Wedding - Fakin NYC
Radio student opasni
Voland Le Mat - Uzalud
radio student, vinyl
Darkwood Dub - Munjevitom Brzinom
valdec o csi 2
The Jam - That's Entertainment
The Cult - She Sells Sanctuary
Drvored - Bura
Trentemoeller - Miss you
The Pop Group - She Is Beyond Good and Evil
Tears For Fears - Sowing The Seeds Of Love
Frank (Just Frank) - die in bed
Motus - Vikend Ratnici
Puncke - Ritam kaosa
Majke - Sveti Planet
And So I Watch you from Afar - Search-Party-Animal
Bauhaus - In Fear of Fear
Arctic Monkeys - Crying Lightning
Pulp - Something Changed
Fugazi - Merchandise
Armstrong! - Winning You
Blondie - Denis
The Jesus Lizard - Puss
The Stepkids - Sweet Salvation
Nick & Bad Seeds, the Cave, Nick Cave & the Bad Seeds - Sleeping Annaleah
DEAD MAN (SOUNDTRACK) - NEIL YOUNG - (00) MAIN THEME
Caribou - Sandy
Suzanne Vega  - No Cheap Thrill
Ladytron - The Lovers
Nothing - Hymn to the Pillory
PJ Harvey - Water
Stefano Bollani - La puerta
Prljavo Kazalište - Nedjeljom ujutro
Exploited - Track  1
